111111111111111111111
10000000P11111111C001
101111110000000000001
101111110111111110C01
10111111C111111110001
1C00000000000000000C1
101111110111111011111
1011111101111110110E1
101111110111111011001
1000000000000000110C1
111111110111111111001
11111C000000000000001
111111111111111111111