111111111111111111111111111111
100000011100000000000000000001
10000001P100000000000000000001
100000010100000000000000000001
11111111C111111111111111111111
1C00000000000000000000000000C1
111111111111111011111111111111
100000000000001010000000000001
100000000000001010000000000001
100000000000001E10000000000001
100000000000001110000000000001
100000000000000000000000000001
111111111111111111111111111111