111111111111111111111
10000000P111111110001
101111110000000000001
101111110111111110001
101111110111111110001
100000000000000000001
101111110111111011111
101111110111111010001
101111110111111010E01
100000000000000010001
1111111101111111110C1
111110000000000000001
111111111111111111111