11111111111111
1P00000E0000C1
11111111111111