011110
1P0001
100001
1C00C1
100001
1000E1
011110