111111
100001
100001
1C00C1
100001
1000E1
111111