111110
1P0000
100000
1C00C0
100000
1000E0
111110