1111111111111111111111
1P111111111C1111100001
1000000000000000000E01
1C1111C11111111C110001
1111111111111111111111